1	2	90	4	3	1	1	1
2	2	85	2	2	0	3	1
3	11	94	2	1	0	5	0	#ScientistMach
4	9	86	1	2	0	2	1
5	4	79	2	1	0	2	0
6	2	72	2	1	0	2	0
7	8	83	1	1	0	4	0