1	1	18	4	3	1	1	1
2	7	21	2	2	0	3	0
3	11	22	2	1	0	5	0	#ScientistMach
4	9	14	1	2	0	2	1
5	4	7	2	1	0	2	0
6	2	0	2	1	0	2	0
7	8	11	1	1	0	4	0