1	2	42	4	3	1	1	1
2	2	37	2	2	0	3	1
3	11	46	2	1	0	5	0	#ScientistMach
4	9	38	1	2	0	2	1
5	4	31	2	1	0	2	0
6	2	24	2	1	0	2	0
7	8	35	1	1	0	4	0