1	2	90	4	3	1	1	1
2	2	85	2	2	0	3	1
3	12	94	1	1	0	5	0
4	9	86	1	2	0	2	1
5	4	79	2	1	0	2	0
6	2	72	2	1	0	2	0
7	8	83	1	1	0	4	0
8	3	0	2	1	0	2	0
9	4	4	3	4	0	1	0
10	4	9	3	4	0	1	0
11	2	40	4	3	0	1	1
12	7	40	2	2	0	6	1
13	5	31	3	4	0	1	0
14	11	26	3	4	0	1	0
15	10	31	3	4	0	1	0
16	10	35	3	4	0	1	0
17	9	40	3	4	0	1	0
18	5	49	2	2	0	5	0
19	4	24	4	6	0	7	1
20	4	41	2	1	0	9	0	1
21	5.4	31.6	2	1	0	9	0	2
22	11	31.5	1	2	0	9	1	0
23	4.3	10	2	1	0	9	0	1
24	9.5	42	2	1	0	9	0	2
