0	0	0	0	0	0	0	0	0	0	0	0	0	0	0	0
0	1	1	1	1	1	1	1	1	0	1	1	1	1	0	0
0	1	1	1	1	1	1	1	1	0	1	1	1	1	0	0
0	1	1	1	1	1	1	1	1	0	1	1	1	1	0	0
0	1	1	1	1	1	1	1	1	0	1	1	1	1	0	0
0	1	1	1	1	1	1	1	1	0	1	1	1	1	0	0
0	1	1	1	1	1	1	1	1	0	1	1	1	1	0	0
0	0	0	0	0	0	0	0	0	0	1	1	1	1	0	0
0	1	1	1	1	1	1	1	1	1	1	1	1	1	0	0
0	1	1	1	1	1	1	1	1	1	1	1	1	1	0	0
0	1	1	1	1	1	1	1	1	1	1	1	1	1	0	0
0	1	1	1	1	1	1	1	0	1	1	1	1	1	0	0
0	0	0	0	0	0	0	0	0	0	1	1	1	1	0	0
0	1	1	1	1	1	1	1	1	0	1	1	1	1	0	0
0	1	1	1	1	1	1	1	1	0	1	1	1	1	0	0
0	1	1	1	1	1	1	1	1	0	1	1	1	1	0	0
0	1	1	1	1	1	1	1	1	0	1	1	1	1	0	0
0	1	1	1	1	1	1	1	1	0	1	1	1	1	0	0
0	128	128	128	128	1	1	1	1	0	1	1	1	1	0	0
0	128	128	128	128	1	1	1	1	0	1	1	1	1	0	0
0	128	128	128	128	1	1	1	1	0	1	1	1	1	0	0
0	1	1	1	1	1	1	0	0	0	1	1	1	1	0	0
0	1	1	1	1	1	1	0	0	0	1	0	0	1	0	0
0	0	0	0	0	0	0	0	0	0	0	0	0	0	0	0